---------------------------------------|
--------x------------x6----------------|
--------x------------x-----------------|
--------x------------x-----------------|
xxxxxx--x---xxxx--x--xCxxxxxxxxxxxxxxx|
--------x---x--x--x--x-----------------|
--------x---x--x--x--x-----------------|
-------2x---x--x--x--x-----------------|
---xxxxxx---x--x--x--xxxxxxxxxxxx------|
------------x--x--x--x-----------------|
------------x--x--x--x-----------------|
------------x--x--x--x-----------------|
----xxxxxxxxx--x--x--x----xxxxxxxxxxxxx|
---------------x--x--x----x-----------5|
---------------x--x3-x----xxxxxxxxxxx--|
-xAxxxxxxxxxxxx--x--x--------------x--|
-------------x----x--x--------------x--|
-------------x----x--x-----------------|
-------------x----x--xxxxxxxxxxxx------|
--xxx--xxx---x----x--------------------|
--x-x--x-x---xBxxxxxxxxxxxx-----------|
----x--x-x---x--x--x-------------------|
----x--x-----x--x--x-------------------|
xxxxx--x-----x--x--xxxxxxxxx---xxxxxxxx|
-------x-----x--x----------x---x------4|
-------x-----x-----------------x-------|
-------------x-----------------xxxx----|
-------------x--------------------x----|
------------1x--------xxxxxx-----------|
---------------------------------------|